ru - Россия
ua - Украина
by - Беларусь
su - СССР
us - США
az - Азербайджан
am - Армения
kz - Казахстан
kg - Кыргызстан
lv - Латвия
lt - Литва
md - Молдова
ee - Эстония
at - Австрия
be - Бельгия
bg - Болгария
uk - Великобритания
hu - Венгрия
de - Германия
es - Испания
it - Италия
lu - Люксембург
nl - Нидерланды
pl - Польша
sk - Словакия
fi - Финляндия
fr - Франция
me - Черногория
cz - Чехия
ch - Швейцария
il - Израиль
tr - Турция

abh - Республика Абхазия
rso - Республика Южная Осетия 
dpr - Донецк
lpr - Луганск

Пример ввода номера:
/s ru a 000 aa 00
/s ua aa 0000 aa
/s by a 0000 a-0 
